13 15
111111111111111
1000000000000G1
101111110001101
101111110001101
101111100001101
100000000011101
101111100011101
101111100011101
101111100011101
101111000011101
101111000011111
1B000000000002
111111111111111
