***************
*            G*
* ******   ** *
* ******   ** *
* *****    ** *
*         *** *
* *****   *** *
* *****   *** *
* *****   *** *
* ****    *** *
* ****    *****
*B           o*
***************
